apple	苹果
banana	香蕉
cat	猫
dog	狗
book	书
house	房子
tree	树
flower	花
sun	太阳
moon	月亮
water	水
fire	火
hand	手
head	头
foot	脚
eye	眼睛
ear	耳朵
nose	鼻子
mouth	嘴
tooth	牙齿
red	红色
blue	蓝色
green	绿色
yellow	黄色
black	黑色
white	白色
big	大的
small	小的
hot	热的
cold	冷的
happy	快乐的
sad	伤心的
good	好的
bad	坏的
fast	快的
slow	慢的
teacher	老师
student	学生
friend	朋友
mother	母亲
father	父亲
sister	妹妹
brother	哥哥
morning	早晨
afternoon	下午
night	夜晚
one	一
two	二
three	三
four	四
five	五
six	六
seven	七
eight	八
nine	九
ten	十
